WWWWWWW
WWGGGGW
WGGGGGW
WGGWGGW
WGGGGGW
WGGGGWW
WWWWWWW