WWWWWWWWW
WGGGWGGGW
WGWGWGWGW
WGGGGGGGW
WWWGWGWWW
WWWGWGWWW
WGGGGGGGW
WGWGWGWGW
WGWGGGGGW
WWWWWWWWW