WWWWW
WGGGW
WGWGW
WGWGW
WGGGW
WWWWW